10 10
0 99
. X . . . . . . . .
. X . X X X X X . X
. X . X . . . X . X
. X . X . X . X . X
. . . X . X . . . X
X X X X . X X X . X
X . . . . . . X . .
X . X X X X . X X .
X . X . . X . . . .
. . X . . X X X X .